4000000000
4000500000
4000000000
4000000000
4000003333
4000003222
4000003222
4000003222