4444444444
4111111111
4100000000
4111500000
4000000000
4000000000
4000000000
4000000000