2223000004
2223000004
2223000004
3333000004
0000000004
0000000004
0000000004
4444444444