0005014444
0500014444
0000514444
0000014444
3333011111
2223000004
2223000004
2223000004