4444444444
1111114444
0000014444
0000014444
0000014444
0000014444
0000014444
0000014444